# COINS TO OPEN DOOR / PTS PER COIN / GAIN PER COIN AFTER OPEN DOOR / MAP TIME (SECONDS)
# BLANK = 0
# HERO = 1
# DOOR = 2
# BOULDER = 3
# WALL = 4
# JEWELS = 5
# EARTH = 6

24 25 0 150

3 6 4 4 6 4 3 3 6 4 6 6 6 3 4 3 6 6 3 6 6 6 6 4 6 6 6 3 6 6 6 6 6 3 4 6 5 6
6 6 1 4 6 5 6 3 6 4 6 6 6 4 4 4 6 6 4 6 3 6 6 6 6 3 6 6 3 6 3 6 6 6 4 6 4 3
6 6 6 6 4 6 6 3 5 6 6 3 6 6 6 6 4 6 6 6 6 6 3 6 4 4 3 6 6 6 6 6 6 6 4 6 4 4
5 6 4 6 6 4 3 4 3 6 6 3 6 6 6 6 4 6 6 6 3 6 6 6 6 6 6 3 6 3 3 6 6 6 6 6 6 4
3 6 4 6 6 6 4 6 6 3 6 4 4 6 6 3 6 4 4 5 6 6 6 6 6 6 6 3 6 3 3 6 6 6 6 6 6 4
3 3 6 6 3 6 6 6 6 4 6 6 6 3 6 6 6 6 6 6 3 6 3 3 6 6 6 6 6 6 3 6 6 5 4 4 6 6
6 6 3 6 4 4 6 6 3 6 3 3 6 6 6 4 6 6 6 6 3 6 3 3 6 6 6 6 6 6 4 6 6 3 6 4 6 3
6 6 4 6 6 6 5 6 6 6 6 6 6 5 6 3 6 6 4 4 3 6 6 3 6 4 6 4 3 6 6 4 3 6 6 5 6 3
3 6 3 6 6 6 6 4 6 4 4 6 6 5 6 3 6 6 4 4 3 6 6 3 6 6 5 6 4 6 6 6 4 6 6 3 6 4
6 3 6 4 4 6 6 6 6 6 3 3 4 3 6 6 5 6 4 6 4 3 6 6 4 3 6 6 6 4 3 6 6 5 6 3 6 6
4 6 4 4 6 6 6 6 6 6 3 3 4 3 6 6 3 6 4 6 4 4 6 6 6 4 6 6 3 6 4 4 6 6 3 6 4 4
6 4 6 3 6 3 6 4 6 6 6 4 4 3 6 6 3 6 6 6 6 3 6 6 6 3 6 6 6 6 6 4 4 6 3 6 4 4 
6 4 6 3 6 3 6 4 6 5 6 4 6 4 3 6 6 4 3 6 6 6 6 3 6 6 3 6 3 3 6 6 6 6 4 6 6 6
4 6 6 4 3 4 3 6 6 3 6 6 6 6 4 6 6 6 5 6 6 6 4 6 3 4 6 6 6 6 6 6 4 6 4 4 6 5
4 6 6 6 4 4 3 6 6 4 6 5 6 6 6 4 3 6 6 3 6 3 6 6 6 3 6 4 3 6 6 6 6 6 6 4 6 6
4 6 5 6 6 6 6 3 6 4 4 6 6 3 6 4 4 3 6 6 6 6 6 6 6 3 6 4 3 6 6 6 6 6 6 4 6 6
6 6 3 6 6 6 6 4 6 6 6 3 6 6 6 6 6 6 3 6 3 3 6 6 6 6 6 6 4 6 6 3 6 4 6 6 6 4
3 6 4 4 6 6 3 6 4 4 6 6 6 4 6 6 6 6 3 6 3 3 6 6 6 6 6 6 4 6 6 3 5 6 6 3 6 2
4 6 6 6 3 6 6 6 6 6 6 3 6 3 5 6 6 6 6 6 6 3 6 6 6 4 4 6 6 4 3 6 6 5 6 4 6 6
3 3 6 6 6 4 6 6 6 6 6 3 6 3 5 6 6 6 6 6 6 4 6 6 3 6 4 5 6 5 6 3 4 6 3 6 6 6  
