# COINS TO OPEN DOOR / PTS PER COIN / GAIN PER COIN AFTER OPEN DOOR / MAP TIME (SECONDS)
# BLANK = 0
# HERO = 1
# DOOR = 2
# BOULDER = 3
# WALL = 4
# JEWELS = 5
# EARTH = 6

12 10 5 150

6 6 6 6 6 6 0 6 6 5 6 3 0 6 6 6 6 6 3 6 3 6 6 6 6 6 6 6 0 6 6 6 6 3 6 6 6 6
6 3 1 3 6 6 6 6 6 6 0 6 6 6 6 6 6 6 6 6 3 5 6 6 3 6 6 6 6 0 6 6 6 6 6 0 6 6
6 6 6 6 6 6 6 6 6 6 0 6 6 0 6 6 6 6 6 3 6 3 6 6 3 6 6 6 6 6 6 6 6 3 6 6 6 6
3 6 0 0 6 6 6 6 6 6 6 6 6 3 6 6 6 6 6 6 3 6 6 3 6 6 6 6 3 6 6 6 3 6 6 6 6 6
3 6 3 3 6 6 6 6 6 6 6 6 6 3 3 6 6 3 6 6 6 6 6 6 6 6 3 6 6 6 6 6 6 3 6 3 0 6
6 6 6 3 6 6 3 6 6 6 6 6 6 6 6 3 6 6 6 6 6 3 6 0 3 6 6 6 6 6 6 6 6 3 6 3 3 6
4 4 4 4 4 4 4 4 4 4 4 4 4 4 4 4 4 4 4 4 4 4 4 4 4 4 4 4 4 4 6 6 6 3 6 6 3 6
6 0 6 6 6 3 6 6 5 6 0 6 6 3 6 3 6 6 6 6 6 6 6 6 6 6 5 6 3 0 6 6 6 6 6 6 3 6
6 6 5 6 6 6 6 6 3 6 6 6 6 6 0 6 6 6 6 6 6 6 6 3 0 0 3 6 6 5 6 6 6 6 3 6 6 6
6 6 6 3 6 6 3 6 3 6 6 6 6 6 6 6 6 6 6 6 6 6 6 3 3 6 3 6 6 3 6 6 6 6 6 6 6 6
6 0 6 6 6 6 6 3 6 6 6 6 6 6 6 6 3 3 0 6 6 6 6 6 6 6 3 6 6 3 6 5 6 6 6 6 0 6
6 3 6 6 0 6 6 3 6 0 0 6 6 6 6 6 3 6 3 5 6 6 5 6 6 6 6 3 6 6 6 3 6 6 5 6 3 6
6 5 3 6 6 6 6 6 6 6 6 6 6 6 6 6 6 3 3 3 6 6 3 6 6 6 6 6 6 6 6 5 6 6 6 6 6 3
6 6 6 6 6 6 6 6 4 4 4 4 4 4 4 4 4 4 4 4 4 4 4 4 4 4 4 4 4 4 4 4 4 4 4 4 4 4
0 0 6 6 6 6 6 6 6 6 6 0 6 6 6 5 6 6 6 6 3 6 6 6 6 6 3 6 6 6 3 6 6 6 6 6 6 6
3 0 6 6 6 6 6 6 6 6 6 3 3 6 6 3 6 6 6 6 6 6 6 6 3 6 6 6 6 6 6 3 6 3 0 6 6 2
6 3 6 6 3 6 6 6 6 6 6 6 6 3 6 6 6 6 6 3 6 0 0 6 6 6 6 5 6 6 6 3 6 3 3 6 6 6
6 6 6 6 3 5 6 6 0 6 6 6 6 6 6 6 6 3 6 6 6 6 6 6 3 6 3 5 6 6 6 6 6 6 3 6 6 6
6 6 6 0 6 6 0 6 3 6 6 3 6 3 3 6 6 6 6 6 6 6 6 6 3 6 3 5 6 6 6 6 6 6 3 6 6 3
6 5 6 6 6 6 3 6 6 6 6 6 0 6 6 6 6 6 6 6 6 6 0 6 3 6 6 3 6 6 6 6 3 6 6 6 3 6
